
                      |
                    !--/     &       &     &
                   !####/  $  *   |  *   |  *     |  >
              !--------------------------------------/
              ,######################################.
              ,######################################.
              ,######################################.
??????????????,######################################.???????????????