
                            |       |             |
                          !--/    !-/            !/
                 |       !####/   *            *!##/ >
              !---/$   !-----------------/$   !------/
              ,###.----,#################.----,######.
              ,######################################.
              ,######################################.
??????????????,######################################.???????????????