


                *                             *      >
              !---/ $             $ !-/$      !------/
              ,###.---/ $     !-----,#.-------,######.
              ,#######.-------,######################.
              ,######################################.
??????????????,######################################.???????????????